-30
26
-11
12
000000000000000000000000000000000000000000000000000000000
111111111111111111111111111111111111111111111111111111110
100000000000000000000000000000000000000000000000000000010
100000000000000000000000000000000000000000000000000000010
100000000000000000000000000000000000000000000000000000010
100000000000000000000000000000000000000000000000000000010
100000000000000000000000000000000000000000000000000000010
100000000000000000000000000000000000000000000000000000010
100000000000000000000000000000000000000000000000000000010
100000000000000000000000000000000000000000000000000000010
100000000000000000000000000000000000000000000000000000010
100000000000000000000000000000000111111100000000000000010
100000000000000000000000000110000111111100000000000000010
100000000000000000000000010100000111111100000000000000010
100000000000000000000000000000000111111100000000000000010
100000000000000000000100010000000111111100000000000000010
100000000000000000000110000000000111111100000000000000010
100000000000000000000000000000010111111100000000000000010
100000000000000000000000000000010011000000000000000000010
100000000000000000000000000000000000000000000000000000010
100000000000000000000000000000000000000000000000000000010
100000000000000000000000000000000000000000000000000000010
100000000000000000000000000000000000000000000000000000010
111111111111111111111111111111111111111111111111111111110
