-9
10
-6
2
00000000000000000000
00000000000011111110
00000011000011111110
00001010000011111110
00000000000011111110
10001000000011111110
11000000000011111110
00000000001011111110
00000000001001100000
